CheckRuntime=검사하기
CreateConfigFile=설정 파일 만들기
Language=언어
SetRuntime=설정하기
Title=ACT 실행 환경 점검
UseYukkuri=Yukkuri 사용
ActLocation=ACT 경로
Check=검사
Config=환경설정
Extra=그밖에
// check
ClickCheck=검사하기 버튼을 먼저 누르세요!
JunctionOk=정상입니다
JunctionNotEqual=다른 위치로 지정되어 있습니다
JunctionNotJunction=다른 프로그램에서 만든 디렉터리입니다
JunctionNotExist=설정이 필요합니다
JunctionFail=설정을 확인할 수 없습니다
ReinstallAct=ACT가 이상합니다. 다시 설치하세요
NeedSettingUp=설정이 필요합니다. 설정하기를 누르세요
TestOk=문제없음
TestFail=검사가 실패함
Source=원본
Target=대상
ConfigPath=환경설정 경로
ConfigCount=환경설정 파일 개수
ChangeTabToConfig=환경설정 파일을 만드려면 환경설정 탭으로 가세요
FinishSetRuntime=설정했습니다
Success=성공
Fail=실패
// config
CfgConfigs=설정 항목:
ItemYukkuri=윳쿠리 사용
ItemUltsco=울트스카 사용
ItemDfassist=DFAssist 사용
ItemPing=네트웍 속도 보기
// overlay
CfgOverlay=오버레이:
ItemHoriz=HORIZOVERLAY
ItemKagerou=Kagerou 오버레이
ItemEnmity=헤이트/어그로 표시
ItemEureka=에우레카 정보
ItemFish=낚시 도움꾼
//
IknowOverwrite=환경 설정을 덮어 쓰는데 동의합니다
CfgWrite=환경 설정을 저장합니다
